11111111111111111111111111111
1P10000010001000101C000010001
10111010101010101011111011101
1000001C10101C101000100000001
10101110111010101110101110111
10101010100000100010101000101
11101011111011111010101C10101
1C1000100010C0100000001010001
10101111101111101010111110101
100000000C0000001010100000101
11111111101111111011101111111
10100000101010001010101000001
1011101C101011101010101110111
1C000010000000001010000000CE1
11111111111111111111111111111
