1111111111111111111111111111111111
1P00000000000000000000000000000001
10111001110011C11100111001110011C1
1000000000000000000000000000000001
1000000000010000000000000000010001
1000000000010000000000000000010001
1011111100C11101110011111100C11101
1000000000000000000000000000000001
1000000000001000000000000000001001
1000000000001000000000000000001E01
1111111111111111111111111111111111
1010101011111111111010101011111111
1111111111111111111111111111111111
