111111111111111111111111111111111111111
1P0000000010100000000010000010101000101
1010111C1110101011111110101110101011101
101010100010001C00000000101000001010001
101110101011111011111111101011111010111
100010001000100010000000100C00000010101
101011101010101111101110111110111010101
1010001010100C0000100010001000001C00101
111111111011101111101011101111111110101
101000001010000000001000101010001000001
101011101011111111111111111010111010111
100010000000100000100010100000000010001
111110111110101110101010101011111111101
101010100000000010101010001010001000101
101010101010111010101111111111101011101
1000001010100010101000000000100000000E1
101011111111111110101011101110111010101
1010000000000000101010100000001000101C1
111111111111111111111111111111111111111
