111111111111111
10000P0000000E1
100000000000111
10000C0000001C1
111111111111111
