111111111111111
10C000000XXX001
11110001110C001
11P00001E000001
111111111111111
