11111111
100P0001
10000001
10C00111
100001E1
11111111
