1111111
100P01
1C1101
101E01
1C1001
1111111
