111111
1C0E01
100111
1001P1
111111
