1111111111111111111111111111111111
1E0000000000C000000000E00000000001
1010010100100000101001000000010101
10100100101010100010010000E0010101
1P0000000000000E000000000000000001
1111111111111111111111111111111111
