1111111111111111111111111111111111
1E0000000000000000000000P000000001
1010010100100000101001000000010101
1010010010101010001C01000000010101
1P000000000000000000000P0000000001
1111111111111111111111111111111111
